------------------------------------------------------------------------------------------------------
------------------------------------------------------------------------------------------------------
--SSSSSSSSSSSSSSSSS-----------------------------------------------------------------------------------
------------------------------------------------------------------------------------------------------
---------------------XX---------------------Eoooo-----------------------------------------------E-----
----------------------------------------E---XXXXXX------------?---------------------------------E-----
----------------------------E--E--E-----------------------oo--------------------------------------XXX-
-------------------------XXXXXXXXXXXXX----------------------------------------------------------------
------------------------------------------------------XX------------------------S------S--S-----------
-----QQQ------XXXXXX----------------------XXXXXXXXX-----------Q--Q--X--------------<>--------XX-------
-------------EXXXXXX-XX---------------------------------------------XX----<>-------[]-----------------
-----------EXXXXXXXX--------------------------------o---------------XXX---[]-------[]-----------------
-------EE--XXXXXXXXX-------------------ooo---------XXX--------------XXXX--[]-E-----[]-----------------
XXXXXXXXXXXXXXXXXXX--------------------XXX----------------XXXXXXXXXXXXXXXXXXXXXXXXXXXXXXXXXXX------XXX
