----------------------------------------------------------------------------------------------------------------------------------------------------------------
----------------------------------------------------------------------------------------------------------------------------------------------------------------
----------------------------------------------------------------------------------------------------------------------------------------------------------------
----------------------------------------------------------------------------------------------------------------------------------------------------------------
------E---------------------------------------------------------------------------------------------------------------------------------------------------------
SSSSSSSS----------------------------------------------------------------------------------------------S----------------------------------SSSQQ----------SSS-----
----------------------------------------------------------------------------------------------------------------------------------------------------------------
--------E-------------------------------------------------------------------------------------------------------------------------------------------------------
----------------------------------------------------------------------------------------------------------------------------------------------------------------
--------S?S---------------<><<<>>>--------------SSQQ-S---------------->-----------------------------------------------------X-------XX------SS?S--QQSSS---------
--------------------------[][[[]]]------------------------------------]-------<--------------------------------------------XX-------XX--------------------------
--------------------------[][[[]]]------------------------>--X--<-----]-------[------------------------------X---------X-XXXX-------XX--------------------------
--------------------------[][[[]]]-EE------------------XXX]XXXX-[-----]-------[-E-E------XX----EEE-----EE---XXXX------XXXXXXX-------XX--------E------------EEEE-
---XXXXXXXXXXXX-XXXXXXXXXXXXXXXXXXXXXXXXXXXXXXXXXXXXXXXXXXXXXXXXXXXXXXXXXXXXXXXXXXXXXXXXXXXXXXXXXXXXXXXXXXXXXXXXXXXXXXXXXXXXX-------XX----XXXXXXXXXXXXXXXXXXXXXX
